juice  /dʒuːs/: nước ép
vegetable   /ˈvedʒ.tə.bəl/: rau
tomato  /təˈmeɪ.t̬oʊ/: quả cà chua
potatoe  /pəˈteɪ.t̬oʊ/: củ khoai tây
fruit : trái cây

basketball : bóng rổ
baseball : bóng chày

draw  : vẽ

cửa 9:
cab : xe taxi
over there: ở đằng kia
passport: hộ chiếu

cửa :12
pork: thịt lơn
cheese: pho mat
beef: thịt bò
wine: rượu
cake : bánh
meat: thịt
hot pot: lẩu

apartment: căn hộ
fridge: tủ lạnh
garden: vườn
warm: ấm
summer: mùa hè 
winter:  mùa đông
fall : mùa thu
spring: mùa xuân

cua 14:
horse: ngựa
during: trong

responsible : chiu trach nhiem
plate : đĩa
blouse: áo sơ mi nữ
a pair:1 đôi
having a picnic: đi dã ngoại
diary: nhật ký
hall: hành lang
tallest: cao nhất
shortest: thap nhat
youngest:  trẻ tuổi nhất
smallest: nhỏ nhất
sneezing: hắt xì
allergic: dị ứng
day off: ngay nghi 
excite: háo hức
host: chủ nhà
schedule: lich trinh
earn: kiếm(kiếm tiền)
host: chủ nhà
bench: ghế dài
town: thi tran
worse: tệ hơn
close to: gần với
the worst: tệ nhất
adults: người lớn
roller coaster: tàu lượn siêu tốc
dining: phòng ăn
hottest: nóng nhất
fattest: béo nhất
sunnier: nắng hơn
funnier: buồn cười hơn
happier: hạnh phúc hơn
happiest: hạnh phúc nhất
pool: hồ bơi
busier: bận rộn hơn
busiest: bận rộn nhất
dining: ăn tối
nicer: tốt bụng hơn
the nicest: tốt bụng nhất
village:ngôi làng
sheep: con cừu
closer: gần hơn
safest: an toàn nhất
safer: an toàn hơn
beans: hạt đậu
noise: tiếng ồn
shout: hét lên
twin: sinh đôi
hello: xin chao